#
Α	stort alfa	k 'ä3 $ p i $ t ë l | 'ä3 l $ f a
α	alfa		'ä3 l $ f a
Β	stort beta	k 'ä3 $ p i $ t ë l | b 'i2: $ t a
β	beta		b 'i2: $ t a
Γ	stort gamma	k 'ä3 $ p i $ t ë l | g 'ä3 $ m a
γ	gamma		g 'ä3 $ m a
Δ	stort delta	k 'ä3 $ p i $ t ë l | d 'e l $ t a
δ	delta		d 'e l $ t a
Ε	stort epsilon	k 'ä3 $ p i $ t ë l | 'e p $ s i $ l å n
ε	epsilon		'e p $ s i $ l å n
Ζ	stort zeta	k 'ä3 $ p i $ t ë l | z 'i2: $ t a
ζ	zeta		z 'i2: $ t a
Η	stort eta		k 'ä3 $ p i $ t ë l | 'i2: $ t a
η	eta		'i2: $ t a
Θ	stort theta	k 'ä3 $ p i $ t ë l | th 'i2: $ t a
θ	theta		th 'i2: $ t a
Ι	stort iota	k 'ä3 $ p i $ t ë l | j 'ou $ t a
ι	iota		j 'ou $ t a
Κ	stort kappa	k 'ä3 $ p i $ t ë l | k 'ä3 $ p a
κ	kappa		k 'ä3 $ p a
Λ	stort lambda	k 'ä3 $ p i $ t ë l | l 'ä3 m $ d a
λ	lambda		l 'ä3 m $ d a
Μ	stort my		k 'ä3 $ p i $ t ë l | m 'ai
μ	my		m 'ai
Ν	stort ny		k 'ä3 $ p i $ t ë l | n 'ai
ν	ny		n 'ai
Ξ	stort xi		k 'ä3 $ p i $ t ë l | k s 'ai:
ξ	xi		k s 'ai
Ο	stort omkikron	k 'ä3 $ p i $ t ë l | 'å $ m i $ k r3 ë n
ο	omikron		'å $ m i $ k r3 ë n
Π	stort pi		k 'ä3 $ p i $ t ë l | p 'ai:
π	pi		p 'ai:
Ρ	stort rho		k 'ä3 $ p i $ t ë l | rh 'ou
ρ	rho		rh 'ou
Σ	stort sigma	k 'ä3 $ p i $ t ë l | s 'i g $ m a
σ	sigma		s 'i g $ m a
ς	sigma		s 'i g $ m a
Τ	stort tau		k 'ä3 $ p i $ t ë l | t 'a f
τ	tau		t 'a f
Υ	stort ypsilon	k 'ä3 $ p i $ t ë l | 'i p $ s i $ l åe n
υ	ypsilon		'i p $ s i $ l åe n
Φ	stort fi		k 'ä3 $ p i $ t ë l | f 'ai
φ	fi		f 'ai
Χ	stort chi		k 'ä3 $ p i $ t ë l | tj 'ai
χ	chi		tj 'ai
Ψ	stort psi		k 'ä3 $ p i $ t ë l | p s 'ai
ψ	psi		p s 'ai
Ω	stort omega	k 'ä3 $ p i $ t ë l | 'å $ m ë $ g a
ω	omega		'å $ m ë $ g a
א	Aleph		'ä3 $ l ë f
ב	Beth		b 'e th
ג	Gimel		g 'i $ m ë l
ד	Daleth		d 'ä3: $ l ë t
ה	He		h 'e
ט	Thet		th 'e t
י	Yodh		j 'o d
ך	Kaph		sj3 'a f
כ	Kaph		sj3 'a f
ל	Lamed		l 'a $ m ë d
ם	Mem		m 'e m
מ	Mem		m 'e m
ן	Nun		n 'o n
נ	Nun		n 'o n
ס	Samekh		s 'a3: $ m ë sj3
ע	Ayin		'a j n
ף	Pe		p 'e2:
פ	Pe		p 'e2:
ר	Resh		r 'e rs
ש	Shin		rs 'i n
ת	Taw		t 'a v
ו	Waw		v 'a v
ע	Ayin		'a j n
